10 10
0 0
7 7
1 3 2 1 2 1 3 2 1 2
4 1 3 1 3 4 1 3 1 3
1 1 0 2 1 5 1 3 1 3
1 2 1 4 3 0 1 5 2 4
1 2 5 2 0 1 3 4 2 1
4 1 3 1 0 4 1 3 1 3
1 1 3 2 5 1 0 3 4 0
1 2 1 0 3 4 1 3 1 3
1 2 4 4 3 3 1 1 2 3
1 1 3 2 1 5 1 3 1 3