5 5
0 0
4 4
1 3 2 1 2
4 1 3 1 3
1 1 7 2 6
1 2 1 4 3
1 2 4 4 3